あいます	THE IDOLM@STER	短縮よみ	
あおえく	青の祓魔師	短縮よみ	
あおぶた	青春ブタ野郎はバニーガール先輩の夢を見ない	短縮よみ	
あずれん	アズールレーン	短縮よみ	
あだしま	安達としまむら	短縮よみ	
あのはな	あの日見た花の名前を僕達はまだ知らない。	短縮よみ	
うたぷり	うたの☆プリンスさまっ♪	短縮よみ	
おたこい	ヲタクに恋は難しい	短縮よみ	
おちふる	おちこぼれフルーツタルト	短縮よみ	
おにまい	お兄ちゃんはおしまい！	短縮よみ	
おれがいる	やはり俺の青春ラブコメはまちがっている。	短縮よみ	
がくます	学園アイドルマスター	短縮よみ	
かげじつ	陰の実力者になりたくて！	短縮よみ	
がるくら	ガールズバンドクライ	短縮よみ	
がるぱん	ガールズ&パンツァー	短縮よみ	
がんすり	GUNSLINGER GIRL	短縮よみ	
きせこい	その着せ替え人形は恋をする	短縮よみ	
きみつづ	君と綴るうたかた	短縮よみ	
きみほえ	キミが吠えるための歌を、	短縮よみ	
きゅうけつきさん	となりの吸血鬼さん	短縮よみ	
きんかむ	ゴールデンカムイ	短縮よみ	
きんもざ	きんいろモザイク	短縮よみ	
くれしん	クレヨンしんちゃん	短縮よみ	
けもふれ	けものフレンズ	短縮よみ	
こいあす	恋する小惑星	短縮よみ	
ごちうさ	ご注文はうさぎですか？	短縮よみ	
こちかめ	こちら葛飾区亀有公園前派出所	短縮よみ	
このすば	この素晴らしい世界に爆焔を！	短縮よみ	
こまり	ひきこまり吸血姫の悶々	短縮よみ	
ささこい	ささやくように恋を唄う	短縮よみ	
ざつたび	ざつ旅-That's Journey-	短縮よみ	
さぼほけ	サボりなら保健室でどうぞ？	短縮よみ	
しかのこ	しかのこのこのここしたんたん	短縮よみ	
しゅたげ	STEINS;GATE	短縮よみ	
しょうしつ	涼宮ハルヒの消失	短縮よみ	
ぜっちる	絶対可憐チルドレン	短縮よみ	
だんまち	ダンジョンに出会いを求めるのは間違っているだろうか	短縮よみ	
てにぷり	テニスの王子様	短縮よみ	
てんすら	転生したらスライムだった件	短縮よみ	
とうりべ	東京リベンジャーズ	短縮よみ	
にんころ	忍者と殺し屋のふたりぐらし	短縮よみ	
のんのん	のんのんびより	短縮よみ	
はがない	僕は友達が少ない	短縮よみ	
はがれん	鋼の錬金術師	短縮よみ	
はなしゅら	花は咲く、修羅の如く	短縮よみ	
はにすか	アンドロイドは経験人数に入りますか？？	短縮よみ	
はるひ	涼宮ハルヒの憂鬱	短縮よみ	
ひびめし	日々は過ぎれど飯うまし	短縮よみ	
ひろあか	僕のヒーローアカデミア	短縮よみ	
ぶんすと	文豪ストレイドッグス	短縮よみ	
ぼざろ	ぼっち・ざ・ろっく！	短縮よみ	
ほしてれ	星屑テレパス	短縮よみ	
ぼっちせいかつ	ひとりぼっちの○○生活	短縮よみ	
まじょたび	魔女の旅々	短縮よみ	
まどまぎ	魔法少女まどか☆マギカ	短縮よみ	
まほあこ	魔法少女にあこがれて	短縮よみ	
まりみて	マリア様がみてる	短縮よみ	
やがきみ	やがて君になる	短縮よみ	
やくねば	約束のネバーランド	短縮よみ	
ゆゆゆ	結城友奈は勇者である	短縮よみ	
ゆるきゃん	ゆるキャン△	固有名詞	
よりもい	宇宙よりも遠い場所	短縮よみ	
よるくら	夜のクラゲは泳げない	短縮よみ	
りこりこ	リコリス・リコイル	短縮よみ	
りぜろ	Re:ゼロから始める異世界生活	短縮よみ	
ろっくれでぃ	ロックは淑女の嗜みでして	短縮よみ	
ろんがる	ロンリーガールに逆らえない	短縮よみ	
わたおし	私の推しは悪役令嬢。	短縮よみ	
わたこん	わたしの幸せな結婚	短縮よみ	
わたたべ	私を喰べたい、ひとでなし	短縮よみ	
わたてん	私に天使が舞い降りた！	短縮よみ	
わたなれ	わたしが恋人になれるわけないじゃん、ムリムリ!（※ムリじゃなかった!?）	短縮よみ	
わたゆり	私の百合はお仕事です！	短縮よみ	
をたこい	ヲタクに恋は難しい	短縮よみ	
