あのはな	あの花	固有名詞	
おちふる	おちフル	固有名詞	
おれがいる	俺ガイル	固有名詞	
がるくら	ガルクラ	固有名詞	
がるぱん	ガルパン	固有名詞	
がんすり	ガンスリ	固有名詞	
きみほえ	キミ吠え	固有名詞	
きゅうけつきさん	吸血鬼さん	固有名詞	
きんかむ	金カム	固有名詞	
きんもざ	きんモザ	固有名詞	
こいあす	恋アス	固有名詞	
こちかめ	こち亀	固有名詞	
ささこい	ささ恋	固有名詞	
ざつたび	ざつ旅	固有名詞	
さぼほけ	サボほけ	固有名詞	
ぜっちる	絶チル	固有名詞	
てにぷり	テニプリ	固有名詞	
てんすら	転スラ	固有名詞	
とうりべ	東リベ	固有名詞	
はがれん	ハガレン	固有名詞	
はなしゅら	花修羅	固有名詞	
ひろあか	ヒロアカ	固有名詞	
ぶんすと	文スト	固有名詞	
ほしてれ	星テレ	固有名詞	
まじょたび	魔女旅	固有名詞	
まどまぎ	まどマギ	固有名詞	
やがきみ	やが君	固有名詞	
よるくら	よるクラ	固有名詞	
りこりこ	リコリコ	固有名詞	
りぜろ	リゼロ	固有名詞	
ろっくれでぃ	ロックレディ	固有名詞	
ろんがる	ロンガル	固有名詞	
わたおし	わた推し	固有名詞	
やくねば	約ネバ	固有名詞	
わたこん	わた婚	固有名詞	
きせこい	着せ恋	固有名詞	
だんまち	ダンまち	固有名詞	
まりみて	マリみて	固有名詞	
うたぷり	うた☆プリ	固有名詞	
あいます	アイマス	固有名詞	
がくます	学マス	固有名詞	
おたこい	ヲタ恋	固有名詞	
をたこい	ヲタ恋	固有名詞	
かげじつ	影実	固有名詞	
しゅたげ	シュタゲ	固有名詞	
けもふれ	けもフレ	固有名詞	
あずれん	アズレン	固有名詞	
あおえく	青エク	固有名詞	
あおぶた	青ブタ	固有名詞	
